00000000
00000000
80000000
77000000
66600000
55550000
44444000
33333300
22222220
11111111