11111111
60000006
60000006
30000003
30000003
30000003
30000003
60000006
60000006
11111111
