55566555
07700770
53322335
02200220
00111100
02200220
77000077
11066011
90888809
90888809