00000000
00000000
00000000
44444444
33333333
22222222
11111111
00000000